############################################################################################           
                                                                                           #           
                                                                                           #           
                                                                                           #           
                                                                                           #           
                                                                                           #           
#                                                                                          ############
#
#
#
#
####################################################################################       ############
#                                                                                          #
#                                                                                          #
#                                                                                          #
#                                                                                          #
#                                                                                          #
##########                                                                                 #
         #                                                                                 #
         #                                                                                 #
         #                                                                                 #
         #                                                                                 #
         #                                                                                 #
         #                                                                                 #
         #                                                                                 #
##########                                                                                 #
                                                                                           #
                                                                                           #
                                                                                           #
                                                                                           #
                                                                                           #
                                                                                           #
                                                                                           #
############################################################################################