#######----+#####################################
#                                               #
#                                               #
#                                               #
#                                               #
#                                               #
#                                               #
#                                               #
#                                               #
#                                               #
#########                    ####################
#                                               #
#                                               #
#                                               #
#                                      #######  #
#                                      #     #  #
#                                      #     #  #
#                                      #     #  #
#                                      #######  #
#                                               #
#                                               #
#                                               #
#                                               #
#                                               #
#                                               #
#################################################